MMMMMMMMMMMMMMM
MCCCCCCCCCCCCCM
MDCMMMCMMMMMMMM
MMMMMMCMCCCCCCM
MCCCCCCMMCMCMCM
MCMMMMMMMCMCMCM
MCCCCCCCCCMCMCM
MMCMMMMMMMMCMCM
MMCCCCCCMCCCMCM
MMMMMMMMMMMMMCM
MMCCCCCCCCCCCCM
MCCMMMMMCMMMMMM
MMCMMMMMCCCCCCM
MMCCCCCMMMCMMCM
MMMMMMSMMMMMMMM