MMMMMMMMMMMMMMM
MCCCCCCCCCCCCCM
MDCMMMCMMMMMMMM
MMMMMMCMMCCCCCM
MCCCCCCMMCMCMCM
MCMMMMMMMCMCMCM
MCCCCCCCCCMCMCM
MMCMMMMMMMMCMCM
MMCCCCCMMCCCMCM
MMMMMMMMMMMMMCM
MMCCCCCCCCCCCCM
MMCMMMMCMMMMMMM
MMCMMMMCCCCCCCM
MMCCCCCMMMCMMCM
MMMMMMSMMMMMMMM