MMMMMMMMMMMMMMM
MCCCCCCCCCCCCCM
MDCMMMCMMMMMMMM
MMMMMMCCCCCCCCM
MCCCCCCMMCMCMCM
MCMMMMMMMCMCMCM
MCCCCCCCCCMCMCM
MMCMMMMCMMMCMCM
MMCCCCCCCCCCMCM
MMCMMMMMMCMMMCM
MMCCCCCCCCCCCCM
MCCMMMMMCMMMMMM
MMCMMMMMCCCCCCM
MMCCCCCCCMCMMCM
MMMMMMSMMMMMMMM
WMMMMMMMMMMMMMM
MMMNMWMPMMMGMMM
MMMMMMMMMMMMMMW